first_name	last_name
Anna	Bedecs
Antonio	Gratacos Solsona
Thomas	Axen
Christina	Lee
Martin	O’Donnell
Francisco	Pérez-Olaeta
Ming-Yang	Xie
Elizabeth	Andersen
Sven	Mortensen
Roland	Wacker
Peter	Krschne
John	Edwards
Andre	Ludick
Carlos	Grilo
Helena	Kupkova
Daniel	Goldschmidt
Jean Philippe	Bagel
Catherine	Autier Miconi
Alexander	Eggerer
George	Li
Bernard	Tham
Luciana	Ramos
Michael	Entin
Jonas	Hasselberg
John	Rodman
Run	Liu
Karen	Toh
Amritansh	Raghav
Soo Jung	Lee
Nancy	Freehafer
Andrew	Cencini
Jan	Kotas
Mariya	Sergienko
Steven	Thorpe
Michael	Neipper
Robert	Zare
Laura	Giussani
Anne	Hellung-Larsen
a
